  #######
  #  .*@#
###  $$ #
#  $ # ####
#    # $ .#
####..  ###
   ######