    ######
    #@#  #
  ###$   #
###   $$ #
#.   $  ##
#.. $#  #
#.#  ####
#.####
###