##############
#@         $.#
#   $       .#
#   $       .#
##############