###########
#@      $.#
#       $.#
#       $.#
#   $  .###
#  $    .#
##########