#########################
#@         $           .#
#          $           .#
#          $           .#
#          $           .#
#          $           .#
#          $           .#
#          $           .#
#########################